bot1_start,bot1_end,bot2_start,bot2_end,player_start,player_end,bot4_start,bot4_end,bot5_start,bot5_end
0,4,0,4,0,4,0,4,0,4
5,9,5,9,5,9,5,9,5,9
10,14,10,14,10,14,10,14,10,14
15,19,15,19,15,19,15,19,15,19
20,24,20,24,20,24,20,24,20,24
25,29,25,29,25,29,25,29,25,29
